########.#######
#     $$$$$    #
#     .        #
#          .   #
#              #
#   .          #
#              #
#     .    #   #
#          #   #
#          #   #
#  S           #
#              #
#   ###    $   #
#   #     $.$  #
#          $   #
################
