########.#######################
#     $$$$$    #               #
#     .                   $    #
#          .   #         $.$   #
#                        $.$   #
#   .      C   #         $.$   #
#              #         $.$   #
#     .    #              $    #
#          #                   #
#          #   #      ###      #
#     M               #        #
#           A        #         #
#   ###    $              .    #
#   #     $.$        .       S #
#          $   #            .  #
################################
