########.#######
#              #
#     .        #
#          .   #
#              #
#   .          #
#              #
#     .    #   #
#          #   #
#          #   #
#  S           #
#              #
#   ###        #
#   #      .   #
#              #
################